7
7
#######
#I    #
#     #
#     #
#     #
#    S#
#######